10.ox
........o.
..........
..........
..........
..........
..........
..........
..........
..........
.....o....
15.ox
...............
...............
...............
............o..
...............
oo.....o.....o.
...............
....o.o..o..o..
.o...o.....o...
...........o...
...o.......oo..
.....o.........
...............
...............
.........o.....
